#########################################
#...#.....  #     #.........  #.........#
#.#.#.###.# # ### #.#######.###.#######.#
#.#B#...#.#   #   #.#     #.....      #.#
#.#####.#.#########.# # ############# #.#
#.#.....#.#.........# #       #   #   #.#
#.#.#####.#.######### ##### # # # # ###.#
#.#.....#...#     #     #   # # # # # #.#
#.#####.######### # ##### ### # # # # #.#
#.  #...        #   #     #   # # #   #.#
#.###.######### # ### ##### ### # #####.#
#...#...#     # # #   #       # #      .#
# #.###.# ### # ### ### ####### #######.#
# #.....# #   #     #   # #     #...  #.#
# ####### # ########### # # #####.#.###.#
#     # # #   #       #   # #   #.#.....#
##### # ##### # ##### ### # ### #.#######
#   # #     # #   #   #   # #   #.....# #
# ### ### ### ### # ### ### # #######.# #
#   #     #   #   # #   #   # #.....#...#
### ##### # ### ### ### # ### #.###.###.#
#       # #   # # #   # # #   #.# #.....#
# ####### ### # # ### ### # ###.# #######
#       #   #   #   # #   #  ...#       #
# ##### ### ##### # # # #####.### ### ###
#   # # #   #     # # #     #.#     #   #
### # # # ### # ##### # ### #.# ####### #
# #   #   #   # #     #   # #.# #     # #
# ### ##### ### # ##### ### #.# # ### # #
#   #       #   # # #   #   #.# #   #   #
# # ######### ### # # ### ###.# ### #####
# #     #   # # # #   #   # #.#   #     #
# ##### # # # # # ### # ### #.######### #
# #   # # # # # #   # #   #  ...........#
# # # # # # # # ### ### # #############.#
# # #     # # #   #   # #       #.......#
# ######### # # # ### ### ##### #.#######
#     #     # # #   #   # #     #.#.....#
# ### ####### ### # ### ### #####.#.###.#
#   #             #   #     #    ...#A..#
######################################## 

