#########################################
#   #       #     #           #         #
# # # ### # # ### # ####### ### ####### #
# #B#   # #   #   # #     #           # #
# ##### # ######### # # ############# # #
# #     # #         # #       #   #   # #
# # ##### # ######### ##### # # # # ### #
# #     #   #     #     #   # # # # # # #
# ##### ######### # ##### ### # # # # # #
#   #           #   #     #   # # #   # #
# ### ######### # ### ##### ### # ##### #
#   #   #     # # #   #       # #       #
# # ### # ### # ### ### ####### ####### #
# #     # #   #     #   # #     #     # #
# ####### # ########### # # ##### # ### #
#     # # #   #       #   # #   # #     #
##### # ##### # ##### ### # ### # #######
#   # #     # #   #   #   # #   #     # #
# ### ### ### ### # ### ### # ####### # #
#   #     #   #   # #   #   # #     #   #
### ##### # ### ### ### # ### # ### ### #
#       # #   # # #   # # #   # # #     #
# ####### ### # # ### ### # ### # #######
#       #   #   #   # #   #     #       #
# ##### ### ##### # # # ##### ### ### ###
#   # # #   #     # # #     # #     #   #
### # # # ### # ##### # ### # # ####### #
# #   #   #   # #     #   # # # #     # #
# ### ##### ### # ##### ### # # # ### # #
#   #       #   # # #   #   # # #   #   #
# # ######### ### # # ### ### # ### #####
# #     #   # # # #   #   # # #   #     #
# ##### # # # # # ### # ### # ######### #
# #   # # # # # #   # #   #             #
# # # # # # # # ### ### # ############# #
# # #     # # #   #   # #       #       #
# ######### # # # ### ### ##### # #######
#     #     # # #   #   # #     # #     #
# ### ####### ### # ### ### ##### # ### #
#   #             #   #     #       #A  #
########################################