######################
#     #             #
#    A  #  #########  #
#     A    #      #  #
###########      ##  #
#        #    ####   #
#  # #     B          #
###################### 

