######################
#     #             #
#    A  #  #########  #
#        #      #  #
###########      ##  #
#        #    ####   #
#  # #     B   B        #
###################### 

