######################
#     #             #
#      #  #########  #
#         #      #  #
###########      ##  #
#        #    ####   #
#  # #               #
######################