######################
#   A  #............ #
#   .  #. #########. #
#   ..... #  .B   #. #
###########  .   ##. #
#        #   .#### . #
#  # #       ....... #
######################

