######################
#   A  #             #
#      #  #########  #
#         #   B   #  #
###########      ##  #
#        #    ####   #
#  # #               #
######################